1111111
1P00001
1101111
10C00E1
1111111