1111111111111111111111111111111111
1E00000000000000C00000C00000000001
1110010100100000101001000000010101
1110010010101010001001000000010101
1P1000001C10C0000000000000000000C1
1111111111111111111111111111111111