1111111
1EP1001
1010101
1000001
1C0d001
1111111