1111111111111111111111111111111111
1100000000000000000000000000000011
1000E0000C000000000000C00000000001
1000000011110000000000111100000001
1000000100001000000000100010000001
100000010C0011110001111000C1000001
100000010000000P000000000001000001
1000000111111000000000001111100001
1000000000001000000000001000000001
10000000C0001000000000001000C00001
1100000000001111000000111100000011
1100000000000000000000000000000011
1000E0000C000000000000C00000000001
1000000011110000000000111100000001
1000000100001000000000100010000001
100000010C0011110001111000C1000001
100000010000000P000000000001000001
1000000111111000000000001111100001
1000000000001000000000001000000001
10000000C0001000000000001000C00001
1100000000001111000000111100000011
1100000000000000000000000000000011
1000E0000C000000000000C00000000001
1000000011110000000000111100000001
1000000100001000000000100010000001
100000010C0011110001111000C1000001
100000010000000P000000000001000001
1000000111111000000000001111100001
1000000000001000000000001000000001
10000000C0001000000000001000C00001
1100000000001111000000111100000011
1100000000000000000000000000000011
1000E0000C000000000000C00000000001
1000000011110000000000111100000001
1000000100001000000000100010000001
100000010C0011110001111000C1000001
100000010000000P000000000001000001
1000000111111000000000001111100001
1000000000001000000000001000000001
10000000C0001000000000001000C00001
1100000000001111000000111100000011
1100000000000000000000000000000011
1000E0000C000000000000C00000000001
1000000011110000000000111100000001
1000000100001000000000100010000001
100000010C0011110001111000C1000001
100000010000000P000000000001000001
1000000111111000000000001111100001
1000000000001000000000001000000001
10000000C0001000000000001000C00001
1100000000001111000000111100000011
1100000000000000000000000000000011
1000E0000C000000000000C00000000001
1000000011110000000000111100000001
1000000100001000000000100010000001
100000010C0011110001111000C1000001
100000010000000P000000000001000001
1000000111111000000000001111100001
1000000000001000000000001000000001
10000000C0001000000000001000C00001
1100000000001111000000111100000011
1100000000000000000000000000000011
1000E0000C000000000000C00000000001
1000000011110000000000111100000001
1000000100001000000000100010000001
100000010C0011110001111000C1000001
100000010000000P000000000001000001
1000000111111000000000001111100001
1000000000001000000000001000000001
10000000C0001000000000001000C00001
1100000000001111000000111100000011
1100000000000000000000000000000011
1000E0000C000000000000C00000000001
1000000011110000000000111100000001
1000000100001000000000100010000001
100000010C0011110001111000C1000001
100000010000000P000000000001000001
1000000111111000000000001111100001
1000000000001000000000001000000001
10000000C0001000000000001000C00001
1100000000001111000000111100000011
1100000000000000000000000000000011
1000E0000C000000000000C00000000001
1000000011110000000000111100000001
1000000100001000000000100010000001
100000010C0011110001111000C1000001
100000010000000P000000000001000001
1000000111111000000000001111100001
1000000000001000000000001000000001
10000000C0001000000000001000C00001
1100000000001111000000111100000011
1100000000000000000000000000000011
1000E0000C000000000000C00000000001
1000000011110000000000111100000001
1000000100001000000000100010000001
100000010C0011110001111000C1000001
100000010000000P000000000001000001
1000000111111000000000001111100001
1000000000001000000000001000000001
10000000C0001000000000001000C00001
1100000000001111000000111100000011
1000E0000C000000000000C00000000001
1000000011110000000000111100000001
1000000100001000000000100010000001
100000010C0011110001111000C1000001
100000010000000P000000000001000001
1000000111111000000000001111100001
1000000000001000000000001000000001
10000000C0001000000000001000C00001
1100000000001111000000111100000011
1100000000000000000000000000000011
1000E0000C000000000000C00000000001
1000000011110000000000111100000001
1000000100001000000000100010000001
100000010C0011110001111000C1000001
100000010000000P000000000001000001
1000000111111000000000001111100001
1000000000001000000000001000000001
10000000C0001000000000001000C00001
1100000000001111000000111100000011
1100000000000000000000000000000011
1000E0000C000000000000C00000000001
1000000011110000000000111100000001
1000000100001000000000100010000001
100000010C0011110001111000C1000001
100000010000000P000000000001000001
1000000111111000000000001111100001
1000000000001000000000001000000001
10000000C0001000000000001000C00001
1100000000001111000000111100000011
1100000000000000000000000000000011
1000E0000C000000000000C00000000001
1000000011110000000000111100000001
1000000100001000000000100010000001
100000010C0011110001111000C1000001
100000010000000P000000000001000001
1000000111111000000000001111100001
1000000000001000000000001000000001
10000000C0001000000000001000C00001
1100000000001111000000111100000011
1100000000000000000000000000000011
1000E0000C000000000000C00000000001
1000000011110000000000111100000001
1000000100001000000000100010000001
100000010C0011110001111000C1000001
100000010000000P000000000001000001
1000000111111000000000001111100001
1000000000001000000000001000000001
10000000C0001000000000001000C00001
1100000000001111000000111100000011
1100000000000000000000000000000011
1000E0000C000000000000C00000000001
1000000011110000000000111100000001
1000000100001000000000100010000001
100000010C0011110001111000C1000001
100000010000000P000000000001000001
1000000111111000000000001111100001
1000000000001000000000001000000001
10000000C0001000000000001000C00001
1100000000001111000000111100000011
1100000000000000000000000000000011
1000E0000C000000000000C00000000001
1000000011110000000000111100000001
1000000100001000000000100010000001
100000010C0011110001111000C1000001
100000010000000P000000000001000001
1000000111111000000000001111100001
1000000000001000000000001000000001
10000000C0001000000000001000C00001
1100000000001111000000111100000011
1100000000000000000000000000000011
1000E0000C000000000000C00000000001
1000000011110000000000111100000001
1000000100001000000000100010000001
100000010C0011110001111000C1000001
100000010000000P000000000001000001
1000000111111000000000001111100001
1000000000001000000000001000000001
10000000C0001000000000001000C00001
1100000000001111000000111100000011
1100000000000000000000000000000011
1000E0000C000000000000C00000000001
1000000011110000000000111100000001
1000000100001000000000100010000001
100000010C0011110001111000C1000001
100000010000000P000000000001000001
1000000111111000000000001111100001
1000000000001000000000001000000001
10000000C0001000000000001000C00001
1100000000001111000000111100000011
1100000000000000000000000000000011
1000E0000C000000000000C00000000001
1000000011110000000000111100000001
1000000100001000000000100010000001
100000010C0011110001111000C1000001
100000010000000P000000000001000001
1000000111111000000000001111100001
1000000000001000000000001000000001
10000000C0001000000000001000C00001
1100000000001111000000111100000011
1100000000000000000000000000000011
1000E0000C000000000000C00000000001
1000000011110000000000111100000001
1000000100001000000000100010000001
100000010C0011110001111000C1000001
100000010000000P000000000001000001
1000000111111000000000001111100001
1000000000001000000000001000000001
10000000C0001000000000001000C00001
1100000000001111000000111100000011
1100000000000000000000000000000011
1000E0000C000000000000C00000000001
1000000011110000000000111100000001
1000000100001000000000100010000001
100000010C0011110001111000C1000001
100000010000000P000000000001000001
1000000111111000000000001111100001
1000000000001000000000001000000001
10000000C0001000000000001000C00001
1100000000001111000000111100000011
1000E0000C000000000000C00000000001
1000000011110000000000111100000001
1000000100001000000000100010000001
100000010C0011110001111000C1000001
100000010000000P000000000001000001
1000000111111000000000001111100001
1000000000001000000000001000000001
10000000C0001000000000001000C00001
1100000000001111000000111100000011
1100000000000000000000000000000011
1000E0000C000000000000C00000000001
1000000011110000000000111100000001
1000000100001000000000100010000001
100000010C0011110001111000C1000001
100000010000000P000000000001000001
1000000111111000000000001111100001
1000000000001000000000001000000001
10000000C0001000000000001000C00001
1100000000001111000000111100000011
1100000000000000000000000000000011
1000E0000C000000000000C00000000001
1000000011110000000000111100000001
1000000100001000000000100010000001
100000010C0011110001111000C1000001
100000010000000P000000000001000001
1000000111111000000000001111100001
1000000000001000000000001000000001
10000000C0001000000000001000C00001
1100000000001111000000111100000011
1111111111111111111111111111111111