1111111111111111111111111111111111
100000000000000C00000C000000E00001
1010010100100000101001000000010101
1010010010101010001001000000010101
10000000C01C1000000000000000000C11
1111111111111111111111111111111111